NO ./path_of_least_resistance
     
     SO ./textures

	F 214,20,1
		
			
EA			./test

		WE                                            ./path_here
		
C 				214,4,1

111111
    1N1           111
    11   1 1 111 1 11 
