NO ./textures/tex.xpm 
     
     SO ./textures/tex.xpm      

	F 214,20,1
		
			
EA			./textures/tex.xpm 

		WE                                            ./textures/tex.xpm 
		
C 				214,4,1

11111111111111111
    1N000000000001           111
    111001111111011111
       1011    10000001
        1       1111101
                     1
