NO ./textures/tex.xpm 
     
     SO ./textures/tex.xpm      

	F 150,0,158
		
			
EA			./textures/tex.xpm 

		WE                                            ./textures/tex.xpm 
		
C 				80,0,200

11111111111111111
    10000000000001           111
    111001111111011111
       1011    10000001
        1       11111N1
                     1
