NO ./textures/tex.xpm 
     
     SO ./textures/tex.xpm      

	F 214,20,1
		
			
EA			./textures/tex.xpm 

		WE                                            ./textures/tex.xpm 
		
C 				214,4,1

1111111111
    1N00001           111
    111001 1 111 1 11 
       1011
        1
